###############################
#p     ** *  1 * 2 *  * b *   #
#*# # #*# # #*#*# # # #*#*#*# #
#   *  *  s**  *  1   *   * * #
#*#*# # # #*# # #*#*# # # # #*#
#f   *     * b*  x  *   1 *   #
# # # # # # # # # #*# #*# # # #
#*  *   *  *  *   f  *    *   #
# # # # #*# # # #*#*# # #*# # #
#*   * s  *  *x   *     t     #
# #*# # # # # # #*# # # # #*# #
# t   *   1 *   f  *  * 2     #
###############################