###############################
#p  s       *  f     b *  *   #
#*#t# #*#*# #*#*# # # #*#*#*# #
#      *  t  **   *     *     #
#*#*# # # #*# # #*#*# # # # #*#
# *        * b*           *   #
# # # # # # # # # #*# #*# # # #
#*  b     *   *   f  *    *   #
# # # # #*# # # #*#*# # #*# # #
#*   * s  *  *x         t     #
# #*# # # # # # #*# # # # #*# #
# x         *   f  *          #
###############################