###############################
#p  s  1    *  f  1  b *  *   #
#*#t# #*#*# #*#*# # # #*#*#*# #
#   3  *  t  **   *   5 *     #
#*#*# # # #*# # #*#*# # # # #*#
# *  5     * b*     4     *   #
# # # # # # # # # #*# #*# # # #
#*  b   2 *   *   f  *    *   #
# # # # #*# # # #*#*# # #*# # #
#*   * s  *  *x   2     t     #
# #*# # # # # # #*# # # # #*# #
# x   3     *   f  *  5       #
###############################