###############################
#p  s  *  1 *  f  *  b *  *   #
#*#t# #*#*# #*#*# # # #*#*#*# #
#   *  *  t  **   *   * *     #
#*#*# # # #*# # #*#*# # # # #*#
# *4 *   3 * b*     *   1 *   #
# # # # # # # # # #*# #*# # # #
#*  b   * * 1 *   f  *    *   #
# # # # #*# # # #*#*# # #*# # #
#*   * s  *  *x   *     t     #
# #*# # # # # # #*# # # # #*# #
# x   *     *   f  *  *   1   #
###############################