###############################
#p  s  *  1 *  f  *  b *  *   #
#*# # #*#*# #*#*# # # #*#*#*# #
#   *  *  t  **   *   * *     #
#*#*# # # #*# # #*#*# # # # #*#
# *  *     * b*     *   1 *   #
# # # # # # # # # #*# #*# # # #
#*  b   * * 1 *   f  *    *   #
# # # # #*# # # #*#*# # #*# # #
#*   * s  *  *x   *     t     #
# #*# # # # # # #*# # # # #*# #
# x   *     *   f  *  *   1   #
###############################