###############################
#p     t* *  1 * 2 *  * * *   #
#s# # #*# # #*#*# # # #*#*#*# #
#  x*  b  ***  *  1   * 2 * * #
# # # # # #*# # #*#*# # # # #*#
#f         x **  *  *   1     #
# # # # # # # # # #*# #*# # # #
#*  s      *  *      *        #
# # # # #*# # # #*#*# # # # # #
#*    **  *       *           #
# #*# # # # # # #*# # # # # # #
#           *   *  *          #
###############################